1111111111
1E000C0001
1000010P01
1010C00001
11111111211