11111111111111111111111111111111111
100000C0000000C000000C00010000000E1
10100100101010100010001000010010101
10100101111010100001001000000010101
10100110001011100001000000010010101
10100101011010100001C01000000010101
100C000000000000C00000C000010000001
10100101001000000101001000000010101
101001001010100100010010000P0010101
100000000C000C0000000000000100000C1
10100100101001010001001000000010101
10100100100101010001001001000010101
1000C0000001010000000000000100000C1
11111111111111111111111111111111111
