1111111111
10P00C0001
1000010001
1E10C00001
1111111111
