1111111111
10000C0001
1000010P01
1E10C00001
1111111111
